1111111111111111111111111111111
10000000C0000000000100000000001
1010000001000000000100000C00101
100000000C000000000000000000001
1000000001000000000000000100001
1000000000000000000C00000100001
1000000001000000000000000000001
1P0000000C0000C000010000C000E01
1000000000000000000000000000001
1000000000000000000C00000100001
1000000001000000000000000100001
100000000C000000000000000000001
1010000001000000000100000C00101
1000000000000000000000000000001
1111111111111111111111111111111
