111111111111111111111111111111111111111111111111111
1P00C00000000000000000000000000000000000000000000E1
100000000000000000000000000000000000000000000000001
100000000000000000000000000000000000000000000000001
100010000000000000000001000000000000000000100000001
100010000000000000000001000000000000000000100000001
100010000000000000000001000000000000000000100000001
100010000000000000000001000000000000000000100000001
100010000000000000000001000000000000000000100000001
100010000000000000000001000000000000000000100000001
100010000000000000000001000000000000000000100000001
100010000000000000000001000000000000000000100000001
100010000000000000000001000000000000000000100000001
100000000000001000000000000000001000000000000000001
100000000000001000000000000000001000000000000000001
100000000000001000000000000000001000000000000000001
100000000000001000000000000000001000000000000000001
100000000000001000000000000000001000000000000000001
100000000000001000000000000000001000000000000000001
100000000000001000000000000000001000000000000000001
100000000000001000000000000000001000000000000000001
100000000000001000000000000000001000000000000000001
100000000000000000000000000000000000000000000000001
100000000000000000000000000000000000000000000000001
111111111111111111111111111111111111111111111111111
