11111111111111
1P000000000EC1
11111111111111
